wwwwwwwwwwwwwwww
w______________w
w__________t___w
w____b_________w
w________t_____w
w______________w
w_______t__b___w
w____b_________w
w______________w
w____w___t_____w
w______________w
w_____b_____m__w
w______________w
w______________w
wwwwwwwwwwwwwwww